id	sequence
synth0	CAGTATGGCCACCAGGGGGCGCTAATATTTGGTCAGGAAACGGGATACCGTGGGAATAGCGCTCCAATGGCCACCAGGGGGCGCTAAGAAGTGTATCACC
synth1	ATATATGGCCACCAGGGGGCGCTATGTAGTAGTACGTCACTGTTAACGACGAACTAATAGAAAAGTCTTACTTTTGGCCACCAGGGGGCGCTATTCGCTA
synth2	GGAGTCAAGTGGCCACCAGGGGGCGCTACACGCTTTCATCCATCAACGTTCGTTAGAAACGTATACTTATTCTTTAATTTGGCCACCAGGGGGCGCTATA
synth3	AGGTTTTTAATATTTGGCCACCAGGGGGCGCTATTTTGAGGGGAGGAGCTTTTATCCAGTCAAGCATGGCCACCAGGGGGCGCTAATGCTTATTTATAAT
synth4	GACAAGTGGCCACCAGGGGGCGCTATACGCCTGCGATTTTACGATCAAAATTTAATCGACATCGATTTGCCGAATAAGGGTGGCCACCAGGGGGCGCTAC
synth5	GCTGCGCATGGCCACCAGGGGGCGCTAATTAGATCGCACTTGTCCCTTAAGTCGACATTGAACTGGCCACCAGGGGGCGCTAGGGGTCTCGCTTGAAAAG
synth6	AATCGTACATGCTGGCCACCAGGGGGCGCTAAGGACCTATGGTATATAACAACTTTGAAATAATGGCCACCAGGGGGCGCTAAAGGCGATTGCTGACCTG
synth7	CTGGCCACCAGGGGGCGCTAAGACACGTACTTTACTTTTACCGTGTAACCTACTCTAACTACTGTACGCGCCCTGGCCACCAGGGGGCGCTAAAAAAAGG
synth8	GGATCTATGGCCACCAGGGGGCGCTAACCATTTGTGTGAGGCAAATCAGCATCGGTTGTAAATGTGTCAGAAGAGTCAAATGGCCACCAGGGGGCGCTAG
synth9	TACGAAGTGGCCACCAGGGGGCGCTAACTAGACGCTGAACACTACACAAAAATCGTACCTCGTCTGGCCACCAGGGGGCGCTAGTATGGCAATTTACCCT
synth10	CTACGCTTTAAAGTACTGTGGCCACCAGGGGGCGCTATGCATACAATAGACCTGTCAAGTTTTGGCCACCAGGGGGCGCTAGGCTACAAGTTCAGTATCG
synth11	GAGTCACAATTGCTGGCCACCAGGGGGCGCTAGTTAGTTGAGCCCCGGTTTTCATATTTCCAGTAGGAATTGGCCACCAGGGGGCGCTAGTATTAGAAAT
synth12	AAGAATCATGGCCACCAGGGGGCGCTATATAATTTCCCACCTACTGTCTAAAGTGGGTAGTCGAGATGGCCACCAGGGGGCGCTATTGGAGTACTCCCTT
synth13	TCAAAGAATGATTGATGGCCACCAGGGGGCGCTAGTAAAATGAGACAGCAGCACTAGTCACAATTTGGAATACATTGGCCACCAGGGGGCGCTAGCCATT
synth14	TGAATTGGCCACCAGGGGGCGCTAGTATGACGTCGTACGAACTACTAGGTCCCAGTTCGGAAATCTCACAGTCTGGCCACCAGGGGGCGCTAGAGATTTT
synth15	GTTCCGATGAGTGGCCACCAGGGGGCGCTAGGACTATAATTCTACATTTGTTGTACACTGGGAACGTGAGTGGCCACCAGGGGGCGCTAGGCGCTACTAT
synth16	AACCTAGTGGCCACCAGGGGGCGCTACAATATGATTGCATGATCATGGAATGAGCACAAACTGGCCACCAGGGGGCGCTAGCAATCCACGTTAAGAATAG
synth17	TGTGGAATGGCCACCAGGGGGCGCTAGCCTATTCGAATGGCATTACTCATGGGGATGTGTGATAGTACCCTTTTCTGGCCACCAGGGGGCGCTAGATAAA
synth18	AGGTTCTAACTAATGGCCACCAGGGGGCGCTAGGTAGTGCACCTGTTTGTGCTCATAGAATGGCCACCAGGGGGCGCTAGTAAGTTCACTCATATGATAC
synth19	CCGCAATTTAAAGTACGGTGGCCACCAGGGGGCGCTAGTCTGCAGGGGGCCAAGGGGGGATCTATACTTGCATTATTTGGCCACCAGGGGGCGCTATAAC
synth20	GACCTGGCCACCAGGGGGCGCTATTATCACAAATTACTAATAACTGAGGTTACCACCTCTTGGCCACCAGGGGGCGCTAGTTTACGAGTCGTTTTGGCAA
synth21	CACTGCTCTCCGACAAGTGGCCACCAGGGGGCGCTAGCAGGAATTTGCGAACCGGGCAGCCACTCCGTCTTGAGATGGCCACCAGGGGGCGCTATTTTAT
synth22	ATTTCCGGTGGCCACCAGGGGGCGCTACGTGACTGATGTTGGGTGTGACTCGCGCCAACTATGGCCACCAGGGGGCGCTATCGGACTTGGCGAACAGACA
synth23	TTGGCCACCAGGGGGCGCTATACAGCGTAGAGTCTCTTAAACATTAAACAGCCTTACAGATTGGCCACCAGGGGGCGCTATTTTACTATAGTGGAAACGA
synth24	TTCCTGTACAGAAAATGGCCACCAGGGGGCGCTAACATTTAAGAAATGAGCGAAAACAGGCTTCAATTAAGTTTGGCCACCAGGGGGCGCTAGCGAACCC
synth25	CTCTGGCCACCAGGGGGCGCTAAGAGAGTTTAGAAAGTGGGCATTGTACTTGGTGGACCCTAGCATGAAACGTTGTGGCCACCAGGGGGCGCTAGGTTTC
synth26	GTACTTTTTATATATGGCCACCAGGGGGCGCTAATCGGACCCTAAGCTAGTATTGCAGCAATCACTGGCCACCAGGGGGCGCTAAAGAAAATAGATAAGC
synth27	GAATGTCCAACACAACTATGGCCACCAGGGGGCGCTATTCCTAGCTTGGCTAAACCGTAAACGGAGATTGCGCATTTAAGGTGGCCACCAGGGGGCGCTA
synth28	GAAGTAACTGGCCACCAGGGGGCGCTAGCCGACATTCCCGAATTAATTAACGGGCATCCTATAGTAATAGTGGCCACCAGGGGGCGCTATAAATTTACAC
synth29	CAACTGACCCTGGCCACCAGGGGGCGCTATTGCCAAGCAAAACGTAAGGAAAATTCTATGCGAGTTCTGAACGATTGGCCACCAGGGGGCGCTATGCTAG
synth30	GCAAAAGTAAAAATGGAAATGGCCACCAGGGGGCGCTAAGGACCAGTGTTTACGATACGAGTGAATATCTGACACCTATGGCCACCAGGGGGCGCTAAGC
synth31	GGTCCCGCAATTCGCTTGGCCACCAGGGGGCGCTAAGAAGAATATGCAAAAGATAGAGCCCAACGTGCCCGGAATGTGGCCACCAGGGGGCGCTAGCATG
synth32	TGGCCACCAGGGGGCGCTACCTCGTCGACCACCTCACAAGGAACGCTTATGCGTTCGCAGCATATTTTTATCATAGCAGCTGGCCACCAGGGGGCGCTAT
synth33	ATTTATGCGACTATGGTTCGTGGCCACCAGGGGGCGCTAACACTGGCAATTCGTCAATACCTTCTGCGTGGCCACCAGGGGGCGCTACTGCTTGAAAATA
synth34	ATTAACCCCTTGTACTCCTATTGGCCACCAGGGGGCGCTACATTGAACTAATATGCACTTTAGCTGGCTTCGCTATGGCCACCAGGGGGCGCTAATCAGG
synth35	TGGCCACCAGGGGGCGCTACAGGGACGTTAGACTCTGAGATATTTCTGCCACCATCCTCAAACCTCAAGTTGGCCACCAGGGGGCGCTAGAACATTCCAT
synth36	GCTGGCCACCAGGGGGCGCTAAGTTTAGTGTTAACCTCGGTGCTCTCGAGCGTACATTTTTATATTAACATCTGCTGGCCACCAGGGGGCGCTAACATGG
synth37	ATAAAATTTCCTATAAGTAATTGGCCACCAGGGGGCGCTATTGATGCGGGGATGTCCACTAATATAGGCATGGCCACCAGGGGGCGCTATTACCATACGA
synth38	AAAAATTCCATGGCCACCAGGGGGCGCTAAAAACTTGTATTGCTCCAAGACAGGTATACTATTGCGGGTGGGGAATGGCCACCAGGGGGCGCTAAAGACT
synth39	AAGCTGGCCACCAGGGGGCGCTAGTTTTGATCTTACCTTTTGAACTCCCCTTTCAGTACGCCTGGTGGCCACCAGGGGGCGCTAAACTGTTTTTTTTAAT
synth40	TGCGGTCCTCTGGCCACCAGGGGGCGCTAACACCATGAGTTATGAGTTTGTAACCACAAGTATTTATGAGATGGCCACCAGGGGGCGCTATGAAGTAGCG
synth41	TCATTAGTTGTTTCATGGCCACCAGGGGGCGCTATTTATATCAACTATAGTATTTTTAGTTAATGGTCGTACTGGCCACCAGGGGGCGCTATAGTGATAC
synth42	GTAAATGGCCACCAGGGGGCGCTAGTTAAAAGCATATATAAGAACCACAATAGCTACCTGGTCCAATTTTCATGGCCACCAGGGGGCGCTACCAGACACT
synth43	CTGGCCACCAGGGGGCGCTAAGACAATGGACCCACTGAAGCAGCAACGCTATAATTGTTATTGGCCACCAGGGGGCGCTAATTAAGACTTACAAGGGAGA
synth44	TTTGGCCACCAGGGGGCGCTATGCCAAGGTATCCAGACCGGTTGCTAATTCCATCTACTCACATGATGGCCACCAGGGGGCGCTACTAAGAAGCATCATA
synth45	AGGCTCAGTGGCCACCAGGGGGCGCTAGAGTTTAAGTTAGCTCAAACCTCGAATAATTAAATCATGGCCACCAGGGGGCGCTACACCGAGGTTTATAACC
synth46	CGGTGATCATCATGGCCACCAGGGGGCGCTACAAAGTAAACCACAAGTTTTCAACAGGTGGCAATATGGCCACCAGGGGGCGCTAATCGGTGTACGCGCT
synth47	TCGGAATCAGCGCCCATGGCCACCAGGGGGCGCTAGAAGTGAAGTTTTATGCTTGTAAATTAGAACTACAGGCGTGGCCACCAGGGGGCGCTATGTATTT
synth48	TGGCCACCAGGGGGCGCTATGTGGATGTATCGAGTACGCCAATCGGGTTTCCATTTCCTAGTTTAAAATACTCTGGCCACCAGGGGGCGCTATCTCCAGA
synth49	TTGGCCACCAGGGGGCGCTATCCGACACTCTCATGTGACGAAAACTGTTTCTCACAATCGTTTAAAAAACTGGCCACCAGGGGGCGCTATAACTCTTCTC
