id	sequence
synth0	CCCAGCAGTTTAAGAACCGCGCTTATTGAATGGCCACCAGGGGGCGCTAGTAGACAAACATGGCCACCAGGGGGCGCTAGTTGTTAGAGGCTAGAGGGCC
synth1	ATGGTGTATCGTGGCCACCAGGGGGCGCTATGGCCACCAGGGGGCGCTATGAACTACAAGCCCACACATTAGATATCCCATATCTCTATAGAAAGGATCG
synth2	GGCTGAGTCAGTTTATCTCGGCCTTTTGTTTTGGCCACCAGGGGGCGCTATCTCTGTGGCCACCAGGGGGCGCTATTCACGTCGCAGTTAAGTAACAGAG
synth3	TCTGAATTGGCCACCAGGGGGCGCTAGTACCGCCCTCGCGCGGGCACCACACGACACGGTGGCCACCAGGGGGCGCTAAACGGCCTTCAATGCACTCGAC
synth4	TCTTACACAATTATGGCAGAGAATGGCCACCAGGGGGCGCTATTGAAGAGCCCTTAATATGCTCTGAGTTCTTTGGCCACCAGGGGGCGCTATAGAGATG
synth5	CACTATGCCTCGGGCCAAGTTGGCCACCAGGGGGCGCTAGCATAGGTTGGCCACCAGGGGGCGCTATATGATTTTGAGGAAACAACATTGACATGGATTC
synth6	AGCCTAACTAAAGTCCCGATGTCTGATAAAGAATGTCCGCCCTTAGGATGGCCACCAGGGGGCGCTTGGCCACCAGGGGGCGCTATGTAAAGCCAGAACT
synth7	GGTGGCCACCAGGGGGCGCTATTGGCCACCAGGGGGCGCTATTGTTTTGAAGTGCCTGTGTGCAATAAACGGTCCCGTATTATAGGGGTTTTTGATATTC
synth8	TCACTTAAAATTAGTTGCCCCCTAAGCTACTGGCCACCAGGGGGCGCTATATTTTACTTTCCTAATGGCCACCAGGGGGCGCTAAAAGATAATGAGTGCG
synth9	GTGCGGGCCTAAATACTACCTGCTATGGAGGCGCCTGCTAAGTCAGGTAACTGATAGTTCGCTGGCCACCAGGGGGCGCTATGGCCACCAGGGGGCGCTA
synth10	ATACTAATCAATAATATAGTACCTAAAAAGTTAGTCAAGGCCTTTGGCGGCTGGCCACCAGGGGGCGCTATGGCCACCAGGGGGCGCTAATGCTCTACGA
synth11	GCAGGCATTAAACTAACTAAACCCCTACAGTGGCCACCAGGGGGCGCTATCAACTATGGCCACCAGGGGGCGCTATATATGCGTGTCGCTGATGAACCGG
synth12	GTGAGAATACCTGGCCACCAGGGGGCGCTAGGCGTAGGTAAGTCTGGTACACATGGCCACCAGGGGGCGCTAAGGGATTTGCGTTTAGTGTCGCTATACG
synth13	AAGTGCTTGGCCACCAGGGGGCGCTAGTGATATGAGTGGCCACCAGGGGGCGCTATGTTCATATACGAACTTCAATATCTGTGACAATACTGGATACATT
synth14	CATGATTAAAATATCATATAGGCTCTTGTGAATTGGCCACCAGGGGGCGCTACAGTGATCGTTGGCCACCAGGGGGCGCTAAACGATTATTGCACTAATT
synth15	AATATTAATGGTGTTACTGGCCACACACGGTACCTACTCCCTGGCCACCAGGGGGCGCTATGGCCACCAGGGGGCGCTATCAAATGGACGAAGTGTATGC
synth16	TGGCCACCAGGGGGCGCTAACTTATATGAGATGATTCCCAAAAGAAAAAATCAGCTTCTGAGAAGCTCATGGCCACCAGGGGGCGCTACTTTTCTTTACT
synth17	TGTCAGCTTACTAAATTTTGGCCACCAGGGGGCGCTAGGCGTCTAGAAAATTGGCCACCAGGGGGCGCTACCCATTGGACCCATAGTACAAATATCTGGA
synth18	TCAGAGACATGGCGTACCGATCTTCAAATGCGTACAGTCTTGTGGGTGGCCACCAGGGGGCGCTAATTTAATTTAAAAGTTGGCCACCAGGGGGCGCTAG
synth19	AGTTTGGCCACCAGGGGGCGCTAGACTGTGTCACCTTCTCAGTGGATGTAACGTGGCCACCAGGGGGCGCTACATAGCATGAAAGGGTAATGTTGGAGTA
synth20	AAATGGCCACCAGGGGGCGCTATTGGCCACCAGGGGGCGCTATTATGCGTTTTTGGTCTTATCACTGTTGTCGAACTCTGGTTAGAAAAACAATAGCTGA
synth21	ACTTCAGGGTAAGACAACGGACATTGAATTGATACGCCACTCTTTGGCCACCAGGGGGCGCTATTGGCCACCAGGGGGCGCTAAGGTGGTGGATTGCTCA
synth22	TACTTATAGTTGGCCACCAGGGGGCGCTAATTTGGCCACCAGGGGGCGCTATGGTATTATACATTTTGAAACATGGCACCACAGCTCACCTTAGAAGTCT
synth23	TTCAGCCAACGATCGGTTCAATATTAGACGAAATGTATGGCCACCAGGGGGCGCTATATTTGGCCACCAGGGGGCGCTATACCTGTACAATCACAGACTA
synth24	TTTATCTGGCCACCAGGGGGCGCTAAAACGCATTTAAAGTGTTTCACAGATCTGAAACGTGGCCACCAGGGGGCGCTATTAGACTAAAACGTCTAATGTC
synth25	CTGCTAAAAATAACTAGAATCAAGTTTCCAGAACTTACGCCATCTTGGCCACCAGGGGGCGCTATTAAAATACGACTGGCCACCAGGGGGCGCTATATTT
synth26	TGCTTGAACTTAAATGGCCACCAGGGGGCGCTACGCCTGATTATTTCCGTTACCCCTCTGGCCACCAGGGGGCGCTACTATGTATAAGGATACTAGGTTC
synth27	CCTACATCACCTCTTTTCTGGCCACCAGGGGGCGCTATTGCTGGCCACCAGGGGGCGCTATATGCACTCCAACTAGTCGTTCCGGTAGTCACTCATACTA
synth28	GACCGACCAGTGATACAATGGCCACCAGGGGGCGCTACAACAGATATTCCGTTATTATTATGTCTTACACCCCACTTGGCCACCAGGGGGCGCTAGTCAC
synth29	GAGCGTCGGGAATGTGCTGATATTCTCCAACGAGTCTATCTTCCTAATTGGCCACCAGGGGGCGCTATGGCCACCAGGGGGCGCTACATCATACTTGTCT
synth30	GGCATGGAAACAGCTGGCCACCAGGGGGCGCTATTCACTATTTATCGTTGACTTGGCTATAGCCTTTGTGGCCACCAGGGGGCGCTATAACGCTTATCTA
synth31	CGCCTGGCCACCAGGGGGCGCTACAAATATCAAATAAGCACGGAAGAATCGCATGTACTGCGCGAAAGATTGTAAAAATGGCCACCAGGGGGCGCTATAT
synth32	GCCAGCAACCGCTGCAAGCCAATTGTATCCGGCCCTGGCCACCAGGGGGCGCTAGACTTGGCCACCAGGGGGCGCTAACGTAGAATGCGTGACTATTTAA
synth33	GTCCAAAAACGACGGCTGCCATTGAACGTTGGCCACCAGGGGGCGCTATTACATGTAGCCAATGGCCACCAGGGGGCGCTACAGATTAGCGTTCTCCACA
synth34	AGGGTGCTACCTGGCCACCAGGGGGCGCTACGACCAGCTAAATAAATGAATCATCTATGGCCACCAGGGGGCGCTATGTTCGTACCAAAATTGAGCCTTC
synth35	ATTTGTTTCTTCCATGAGTGTCTGCGATGATGATTGGCCACCAGGGGGCGCTACCTTTTGGCCACCAGGGGGCGCTATTCGAGAGTAAATTTGGTAATGT
synth36	TACCAGCGATAAGACATTGGCCACCAGGGGGCGCTAGGATTGGCCACCAGGGGGCGCTATACATCCCTGATCTCCATTTGTGACTGGTTGATTAATCTTC
synth37	ACAAATTAAAGTTTAAGCACTTTCGGAATATATCGTTATTGGCCACCAGGGGGCGCTATAATGGCCACCAGGGGGCGCTAGGTACAAGCGAGTCCTGAGA
synth38	TCATCTAATGGAGTAATAGTGGCCACCAGGGGGCGCTAAATGCTCCTGAGACTTTCACTTTCTCCAAAAAATGCCCATGGCCACCAGGGGGCGCTAAAAT
synth39	GGGTCTTCTTTCTCTTAGGAAGATGGCCACCAGGGGGCGCTAGCATGGCCACCAGGGGGCGCTAATCAGATTAGTCAATTTATAGTATCTAGATTGCAGT
synth40	CAGGTGTTATCTCGAATCCGTGGTAGGTAGTGGCCACCAGGGGGCGCTAGTAGGGCGAGTTCCTTTCTGGCCACCAGGGGGCGCTATATCAAGGCCATAT
synth41	GGAGCCGTTACCAGACGCAGTCGAAATGCTGGCCACCAGGGGGCGCTAGCATAGAGACTACCGTAATAGTCGTTACTGGCCACCAGGGGGCGCTAAGACC
synth42	TGGCCACCAGGGGGCGCTAAGTTTATTTGGGGCACACTATCAGCGCTAGTCAATTTAGTAGAAACGGCGATCTACTGTGGCCACCAGGGGGCGCTATGGC
synth43	TCAGCCATTTTGAGATGGCCACCAGGGGGCGCTAATAGAAACTATATTGGGTTTGGCCACCAGGGGGCGCTACGAAAGTCAGCCAAGCGTTTGAAGGCTC
synth44	TTAATTAGTAAGAATCGAGCCGTAAAGGGTAGATGATGGCCACCAGGGGGCGCTAGTTCGTCTGGCCACCAGGGGGCGCTAGCGTTTAATGGTGTTTTTG
synth45	TGTGGATTATTTCCAGATTCGCCATTGTGCGCTCACTGAGCCTCCAATGGCCACCAGGGGGCGCTATCTGGCCACCAGGGGGCGCTAAAAGATTTCACAA
synth46	TCCAACTAATCGCATCTAATGGCCACCAGGGGGCGCTAGATCTAGGTGATGTTATTGGCCACCAGGGGGCGCTAAATGGGAACTTACGAACGCAAATAAA
synth47	TGTGACATTGGCCACCAGGGGGCGCTAGGCGAATATAAGTCTTTCCTTTCATTGAACATGGCCACCAGGGGGCGCTATTTGCCTCCGTGTGTAGTATAAA
synth48	ATAGATACTCTATGTCTTACAATGATGGCCACCAGGGGGCGCTATATAGACTAATATATTGGTGGCCACCAGGGGGCGCTAAGATAGTCAATAGGTCCCA
synth49	AATTGGATCTACAATCGCTACGACGTAGGACCAGAGAATTCGACGTGGCCACCAGGGGGCGCTAGGATACTTACATGGCCACCAGGGGGCGCTAAGATGA
