id	sequence
synth0	TCGCTACTCGAGAGTGTATCCCAAATATGGCTTGGCCAAATTTACACTAAATTAGAACTAAGGAATCACTGGCCACCAGGGGGCGCTATCAAATGTCCCA
synth1	ATTCAGTTGAATAAAACTTGGCCACCAGGGGGCGCTAGTAAACTGGCCACCAGGGGGCGCTAAACGGGCTGGCCACCAGGGGGCGCTAATCTAATGTAAT
synth2	ATTGGCCACCAGGGGGCGCTAAAGTTTACCTGACATCCGACCTTCAGAATTTGAAACGTAGACAAAGTTGGCCACCAGGGGGCGCTAACCATTCATTCTG
synth3	ATTGGCCACCAGGGGGCGCTTGGCCACCAGGGGGCGCTATGGCCACCAGGGGGCGCTATGAAAGGGACCGGTAATGGCCACCAGGGGGCGCTAATATATG
synth4	ACGAAATGGCCACCAGGGGGCGCTACCATACTATACCGGCGCGTGTGGCCACCAGGGGGCGCTACTTAATGGCCACCAGGGGGCGCTATATCGAGGGATG
synth5	CATCAGCGACAAGCCGAGAGTGTGGCCACCAGGGGGCGCTACAATTTTGGCCACCAGGGGGCGCTATATGGCCACCAGGGGGCGCTATCGCTTCAATCTT
synth6	GAGGTGACCGGATGTCATCCGTATTAATATAGGATCTACTGTTGGCCACCAGGGGGCGCTAATCCTCTCATATTATTACGGTTTGAAAGTTGCACAAAAT
synth7	CTTTTGATGGGTTGGGTGTGGCCACCAGGGGGCGCTTGGCCACCAGGGGGCGCTACTGGCCACCAGGGGGCGCTATGGCCACCAGGGGGCGCTATGTGCT
synth8	AATTCGAATCGTACTAACAGCCTGTGGCCACCAGGGGGCGCTAGTAACTTACACTCTAAACTGCTTGCTTTATGAAGGTAAGGCTGATATGACTCAGCAT
synth9	ACGAGTTATATACGCACTTGAGTTCCTATCTTTTATTGTGAATCCTTATGCCTTTCGTGGAAGCTGATGGCCACCAGGGGGCGCTACTCAGAGGGAATTT
synth10	AATATCGAATTTTAGTATCACTAGTTGGCCACCAGGGGGCGCTACGGTCGTACATGAATTTCGCTAGAGCGAAAGTAATCATTTTTGGTTCACCTGGCAT
synth11	TTGTGAATCGTCTTCACAAGGGAGTACAGTTAGTAAGTTTAACTGTGGCCACCAGGGGGCGCTATAGGAAAAACCGTGTTGTATAAGCTGAAAAAGAGTA
synth12	ATGGGCCTTAATTAGGCGTCTTTATCCCAGATTGGCCACCAGGGGGCGCTAGGCGAAGAGGCATTCACATCAATTAGTCTAACAATGCGAGCAACCATAG
synth13	GATATGGCCACCAGGGGGCGCTACAGGTATAGTACGAAAATCTGGCCACCAGGGGGCGCTTGGCCACCAGGGGGCGCTATGGCCACCAGGGGGCGCTAAA
synth14	TCGGTATAAATACTTTAGGTTTACAGGCGGCACATTGCCGAAGAAAATGATGGCCACCAGGGGGCGCTATGATCCCTATAACTTCTTAATAGTGCAAATG
synth15	CATTATGGCCACCAGGGGGCGCTAAGTCATCAACTACATAGCTGCCGATCGGTTTGTTAGAGACGGATGTAACTATGGCCACCAGGGGGCGCTAATAGCA
synth16	GTATACTAATTAAAGCTATGGCCACCAGGGGGCGCTACTGCATCAAGTGTGGGCACGATTCGGGTCAAGCATTGGGCTATGGTTGATGGAACATACTTCA
synth17	TCGTCTTGTTAGCTTGGTTACCAATTACAACTAAACAAAATGGCCACCAGGGGGCGCTAGGATTGTGGCTTGGCCACCAGGGGGCGCTACCTAGTCGCGT
synth18	CGACTATTAAAAGAATGTCTAATTTGGTGGCCACCAGGGGGCGCTATATTCGTTAATATAACCATACAAGCTGCATCTCGTTCACATGGCGTACTTCTAG
synth19	GATGGTGCATTGGCCACCAGGGGGCGCTAACAGTGCAGGGCTTAAAATTAAAAGTGTGAATAATACGCCTGGCAAAGTATACGTGATTAGGGATCAAGTT
synth20	CCGAGATTTGGCCACCAGGGGGCGCTACTGGCCACCAGGGGGCGCTACGTGAACCTCATTTTGGCCACCAGGGGGCGCTAGGAGGACCTCCTCGAGGGAC
synth21	ACCATGTAAAGAGTGTGAACAAGCAAGCACACCATTTGTTTCTGTCGACTCCATGGATACGAATCAGGACGATTCAGTCTGGCCACCAGGGGGCGCTAGC
synth22	AATGAAAACCATATGGGTTTTCGAGGGGGCGAGCATTTTGTGGGCAAGTCCGAGCTGGCCACCAGGGGGCGCTATGATGGCCACCAGGGGGCGCTATAGC
synth23	CTTGGCCACCAGGGGGCGCTACAATGGAAGCTATGGGTTTACGATTCTTATCCATCCTATCATTAGGGGAAGCCGTTCGCCTGCCGCCGTAAAGTAGTAA
synth24	CATTACGACTGATGGCCACCAGGGGGCGCTAACCAGAGCTTCCCTCAGATCCAACTCATCTCTGAGGTTACTGAATACGCATCCCCAGATTGTAATTTAT
synth25	GATCAGACCTCTCGTTTAATTATTTTAATTTCTCTGGCCACCAGGGGGCGCTAGATAGCTTACAGCAGTTGGTAAGCTGGCCACCAGGGGGCGCTACAAC
synth26	CCGAGGTAAATATCCCCTAACCCAGTGGCCACCAGGGGGCGCTATTGGATAGGTGGATGGTCGATTTGGCCACCAGGGGGCGCTATGAAGAAAGTAAGAT
synth27	TCGTGGCCACCAGGGGGCGCTACAACTCTGAACCTCATTCAGACCAAGTTGTTAAGCTGGCCACCAGGGGGCGCTTGGCCACCAGGGGGCGCTAGGCCCT
synth28	TTGAACGTGATTATATGTTAAGACATTCTGTACAGACACTTGGCCACCAGGGGGCGCTAACTAGAACTGATCTAATGGCCACCAGGGGGCGCTATCCTGG
synth29	AATTTTCAAGCACAGCCATCTTGGCCACCAGGGGGCGCTAAGCCCCGTAAGCTTGCCCGGGACATGGCCACCAGGGGGCGCTACTTCCGTTATTGACCTG
synth30	GCTGTTTAAAATGATTTTCTGTATAATGGCCACCAGGGGGCGCTAAAAGGTAACGGTCGTGGCCACCAGGGGGCGCTAATAAACTCTTGTGGGACCAGGA
synth31	GACTCTTTAATCCAAGTAATAACTTTACTAGTATAGAGCTTGGAACCTATTGCACCATCTTGAAAAACTGGCCACCAGGGGGCGCTACAAAGTTCCCCAT
synth32	GGACCCTTCCAATGGCCACCAGGGGGCGCTAGTTAGCTGGCCACCAGGGGGCGCTAGACTGGCCACCAGGGGGCGCTAAGCCAGAGTTGAAAGCAAGAGT
synth33	TGCTGGCCACCAGGGGGCGCTATGAATGGGATGAACTGTAGAATTATTTCTTATATCATAGGCGGTCGATGTTCGGGCTTTCGCTTTTGGTACATTGGAA
synth34	TTCGTCCTGAATTTGGCCACCAGGGGGCGCTACTACTTTTAGAGGCCGTAAAGTAACAAAAGCGTCACTGAGTGTAGCCCTCAAAGGGCCTCACTTCTTT
synth35	CGGTGCTTCGTACCGTTAAAATATTAATCGTGGCAACCGATTGGCCACCAGGGGGCGCTACAGCAAATAGTTGATTTACAAAATACGAGTTTTGTCTATA
synth36	TGGATCTGTGAACAACACAACGCGCTTGGCCACCAGGGGGCGCTAGTTATAAAATTAGACCGAGTTTTGATGGCCACCAGGGGGCGCTAACTATAATGAG
synth37	TGTTACGATTAGTCTCTTCCTTTGGATGTAACAAAGGTTATCGCTACCCCTTTGGCCACCAGGGGGCGCTATACGCGGATCTGGGTTCTGCTGGAACTCG
synth38	GTCTGGACGTAACGCTGGCCACCAGGGGGCGCTATATCGGTGGCCACCAGGGGGCGCTAAATTTGGCCACCAGGGGGCGCTACGTATGGAGCGCTCCCAG
synth39	TGCTGGCCACCAGGGGGCGCTATTGATGGCCACCAGGGGGCGCTATCTGGCCACCAGGGGGCGCTTGGCCACCAGGGGGCGCTATTCGGACCTTTCCAAT
synth40	ACCGCTCTTAGGATGAGGGCCTCCTCATAGATCAAAACCACAAAGAGGGTTTCGTTGGCCACCAGGGGGCGCTACCTCTTCTGGCCACCAGGGGGCGCTA
synth41	GTGGTGGCCACCAGGGGGCGCTAACATCATGTAAACACTGGCCACCAGGGGGCGCTAGCAATATGTGGCCACCAGGGGGCGCTAGTCTTCATTGGATGTC
synth42	AATTTTCAAGGACAAGAAACTTCGTTTATCCTGGCCACCAGGGGGCGCTTGGCCACCAGGGGGCGCTATTTCTATACAGAATAACGTTTTTAAATAGCAT
synth43	TAAAATGGTACCTAGTAATCCAAAGAAACACACGATTCCATTTAACTGGCCACCAGGGGGCGCTACCGTCACTTACGCGTTACGCGACCTTCAAAGGACA
synth44	CGATAATTATCAGTGTCACAGAAATTATATAACGCCCTTGGCCACCAGGGGGCGCTACTTATAATTGGAATTACGAACATTTCATAAAGTCTTACAATCG
synth45	ATAGGTCGGACGTTCAATACCTGGCCACCAGGGGGCGCTAGTCCTATCCCCTAAAGCTAGAACCATCTCCAGCCAGCTAAGGGTATGAATAAACATATCT
synth46	GCCGACTTACACGGATCAGGTATAAGTATGGTATAAAGCAAGTATCTTATTAAGACAGCTGATTGGCCACCAGGGGGCGCTATTTGTAAGAATAGATCAC
synth47	ATTGAACATTTACTACCATCTATCGTATATGTATAGTTTAGTGAGTTATGGCCACCAGGGGGCGCTACTTAATTCCAAGTTAGAGCAAAACCTCCATAGT
synth48	TATATATATTTAACTTGGCCACCAGGGGGCGCTAATTGGCCACCAGGGGGCGCTATAGCTTGGCCACCAGGGGGCGCTATCAGGAACGTCGTCATTGCAG
synth49	AAATTCTGCTGATTGACCGAATGTAGCAGTGCTCGATGGCCACCAGGGGGCGCTTGGCCACCAGGGGGCGCTATCGCGGTGTGCTCGTATCAAGGCTCTG
