id	sequence
synth0	TCTCTAAGTTAGCGTAAGTTGGCCACCAGGGGGCGCTACACGACAGATTTTGCTTTTACGATTATGGCCACCAGGGGGCGCTAACATGGTGGTAAGAACA
synth1	TGTTAAGTTGATATTATGGGTGGCCTGATAAAGAAGATGGCCACCAGGGGGCGCTAGGTTGGCCACCAGGGGGCGCTAGGTTGATTTCAGATACAGACAG
synth2	TGGAGAGATCCTACAAGAGATAAAAAACGGGCTAATGATGGCCACCAGGGGGCGCTATTATTGGCCACCAGGGGGCGCTATGATTCTGATATAGAGAAGT
synth3	TGTCAAGTAATAATGGGCATGAACATCCAAAGTGGCCACCAGGGGGCGCTAGCAATAATTGGTGGCCACCAGGGGGCGCTATCTGTGACTATACGTCAGT
synth4	TGTATTTTATAGAAGACTTGATGGAACCGACATGGCCACCAGGGGGCGCTATCTTGGCCACCAGGGGGCGCTATTGTTGACCATATTCCTCATTTGTACA
synth5	ATACGTCCTAATAATAGTTGCCATGAGACTAAATATTGGCCACCAGGGGGCGCTAGTGGCCACCAGGGGGCGCTACTATTGGGAACAAAGATTATGTAAA
synth6	GGAGAACTCAGTACTTATTGGCCACCAGGGGGCGCTAGAATTCCCGCGATTAGAAGATAGGTGGCCACCAGGGGGCGCTAGCATCAGCGGATAAATGTAC
synth7	CAGAAAACTTTTTGATATACAATGAGGATAGTGATGGCCACCAGGGGGCGCTACATCTGGCCACCAGGGGGCGCTATGCACTTGTTTAGAAGCCTCAGGT
synth8	ATGTAAGTATCTGGTTGGCCACCAGGGGGCGCTATATTAACTGAAAAATGGCCACCAGGGGGCGCTATGTCCTCACTCACTTCGGCGATGTTTAACACTC
synth9	GTCTCTTTACTCTTTACCGGTTGAGGACATGTGGCCACCAGGGGGCGCTATGGCCACCAGGGGGCGCTAACGATTATTCAAATGATCCATCGGTGTTAGC
synth10	ATTATTAAGGTCTTAATGTGGCCACCAGGGGGCGCTATTGTTGGCCACCAGGGGGCGCTATCTCTAAGTCATTTACACGATAAGCACGGAATGTGCATCG
synth11	TTTTTTGATCAATTACGAGGTATGGCCACCAGGGGGCGCTAAAGATATTGTTGACGATCTGGGTGGCCACCAGGGGGCGCTAAGCTTATGGAATGTCCAG
synth12	TCGATGTGAATGGATATTTTGATTATGCGGGGCCGAATTTGGCCACCAGGGGGCGCTATTGGCCACCAGGGGGCGCTATGTACGCGCATTAGAGCGGCAC
synth13	AAAACCCGCCACAGGCAACGAGTCAATCTTGGTATTCTGGCCACCAGGGGGCGCTACATGGCCACCAGGGGGCGCTATCCTACTGGGCTCTATATTTACT
synth14	CATACTTCTTCTAACGTGACACTCCACTAATGGCCACCAGGGGGCGCTAACCAGAATTGGCCACCAGGGGGCGCTACAGGAGTGAGAAATATAATGAACA
synth15	AGAGCCTTATGGAAAGCCTTAGGAAAACTTGGCCACCAGGGGGCGCTATGGCCACCAGGGGGCGCTAGTATAATGCTTATAACAAACATAAATATAGCAG
synth16	TTCATTGCTTTGGGTACTTTGAAAGTATTAAGATAAGCTGGCCACCAGGGGGCGCTATGCGGTCTGGCCACCAGGGGGCGCTAGTATAATGAGTGCATTC
synth17	CCTAATTCTCCGCAAGGCAGGTTGGCCACCAGGGGGCGCTATTGTGGCCACCAGGGGGCGCTATGATAACGGTGTTCGATTCGTGATTGGTGGCTGAAGT
synth18	ACGTTAATAAAAACCACGACGTGGGCGTACTCCTACCAGTGTGGCCACCAGGGGGCGCTAGTGCTTGGCCACCAGGGGGCGCTATACTGAGAGCCTGTAT
synth19	AGGATTGTCACGCTTCTCAATCTGTACTAATGGCCACCAGGGGGCGCTAATGGCCACCAGGGGGCGCTAGTCGGGTGTGCGCAAGGCAAATCCATGCTAT
synth20	GGTTAGAGTGTCATTTGAACTCTAGAAGCTTGGCCACCAGGGGGCGCTAAAATGCGTGGCCACCAGGGGGCGCTATCAATTTCAAATGGCTTTTAGATCT
synth21	TGCGGCAAGTTCTCTTGCTGTCCAGAGGTGGCCACCAGGGGGCGCTAACTCATATTAACCTGGCCACCAGGGGGCGCTAAGACTTACATCATTAAAAGAA
synth22	TTTTATAATATAAAACAACAAAGTGGCCACCAGGGGGCGCTATCCGTGAGTAGAAATGTAAATCTGGCCACCAGGGGGCGCTAGCGTGGTTATTTGAAAT
synth23	TAGCAGACATTGGTCCGATCTCTTCCTTGGCCACCAGGGGGCGCTAGGGTTAATGGCCACCAGGGGGCGCTACTTTCTGAAAAGGCTAATTACTGAAAAA
synth24	AAGGATCCTGTATAAGGATCATAATATTGTCGTTTGGCCACCAGGGGGCGCTAACGCTTTTTGGCCACCAGGGGGCGCTAGTCATCGAAATAGGACAATG
synth25	AGTTTTATACGCAAACGCTTCAACTACCGTATGGCCACCAGGGGGCGCTATGCACGGTAGTAGTGGCCACCAGGGGGCGCTAAAATACGGGTGATCATAA
synth26	TATAAGTCTTATCAGTTGGCCACCAGGGGGCGCTATACACTCAAATGGCCACCAGGGGGCGCTAAATTTATCAGCCATTGCATCTTACTACAGAAGCTGG
synth27	TTCCTTGTGTTTTTCCTCGGCGCTTTCGACATTAGGATTGGCCACCAGGGGGCGCTACACGCTGGTGGCCACCAGGGGGCGCTACCATATTAATGCACGA
synth28	CGCTGAGATTGTATAATGGCCACCAGGGGGCGCTACTTCGGATCCAGCATAAAGGACACGTGGAATGGCCACCAGGGGGCGCTATTCATATGGGTATCTT
synth29	ATTAATCATCGGAATTGGCCACCAGGGGGCGCTATCCTGGCCACCAGGGGGCGCTAATTCTCACGGATCTGACTTACTTAGGACAGGCGCCAAAAAATTG
synth30	TGGTATGGATCTCTATGGCCACCAGGGGGCGCTTGGCCACCAGGGGGCGCTAAGTACAGTCAAAGAAAAAATTTTATGCGGTAACTTTTTAGGCCCTAAC
synth31	AGTATGTGCTTCTGCCTATAAATGGCCACCAGGGGGCGCTAACACGCTTTGATTCACAAAAATGGCCACCAGGGGGCGCTAATATGGACGAATTCACAAA
synth32	TCTTTAGTCGAAAGATAACAATAAAACCAAAACATCTTGAAACTGGCCACCAGGGGGCGCTATGGCCACCAGGGGGCGCTAAACTTCCATTGCGTTAGAT
synth33	GGCTGGTATGCATGTTCAATCGTTTGGCCACCAGGGGGCGCTATGATGCAATCAACCACGTACTGGCCACCAGGGGGCGCTAACGGAGTGGGGTGTTGTG
synth34	AGTGATAAACATGGCACGGCATCTACTACTAATTGGCCACCAGGGGGCGCTACTGGCCACCAGGGGGCGCTAAGACCTTATGAAATTATAACAAATTTTA
synth35	GATTTCTGCACCCTGCCACTTGAAGATATGGCCACCAGGGGGCGCTACTATTGGCCACCAGGGGGCGCTAATGTCATACGACAATTGGGATTTAGGGATC
synth36	ACTTCCCACTCAAGAACAACAAGAAATAAATAGTGGTCTTGGCCACCAGGGGGCGCTACGTCGAAATGGCCACCAGGGGGCGCTAAATGTAGGAATTGTT
synth37	CCACAGATAACTTGTCGGTATGGCCACCAGGGGGCGCTAGATTTATGGTGGCCACCAGGGGGCGCTAAGTCCCCGAGGTAAACTACTAATGACTAAAGCC
synth38	GACTTTCGCAGACGTGTTCCTGGCCACCAGGGGGCGCTACGTCAGAAGGTGTCAATTGGCCACCAGGGGGCGCTACGAGACATAAGAAGAGTTAATGTAA
synth39	TTTGGACTTCAGCGCAAACACCCGCATGGCCACCAGGGGGCGCTAATGGAATTGGCCACCAGGGGGCGCTATTGTGAAATTATGAATTAACGCTATAATT
synth40	AGGGAAAGTACTACACCTACAAAGTTGTACGATGGCCACCAGGGGGCGCTAATGGGTGGCCACCAGGGGGCGCTAAAACGGTACCAAAATGTATAAGTCA
synth41	TTCGGTGTGGTGCAATCTGGCCACCAGGGGGCGCTACCGCCAGAAGATTTGGCCACCAGGGGGCGCTACCAGTGATATTATCGGAGCACCAGGCTCTATC
synth42	TGTATCGTGGTCAACTTAGCCGCTGGCCACCAGGGGGCGCTACAAATCTGTTCCTTTTTATCATGGCCACCAGGGGGCGCTAAAAAAAGGTCATAGTTTA
synth43	CCCTGATAAAGTTCTGCAGCGACTTTATTGAATGCTGGCCACCAGGGGGCGCTAATTGGCCACCAGGGGGCGCTAAAAAAGAACCCTGGCTTTTAAATGT
synth44	ACTAGTGTTCTGTTACTATAGGGATGCAGGGCTTTGAGTGGCCACCAGGGGGCGCTATTGGCCACCAGGGGGCGCTAGATGAAGATGATTCCCTAGTGCC
synth45	GTTAGGCAGGCTTGTAAGACCGACCATCTCTTATGGCCACCAGGGGGCGCTTGGCCACCAGGGGGCGCTACGGATTGCTATTTAACATCGTGGTTTGGCT
synth46	TATATGTAGATGGTCTGATTCTTAGTTCTTTATGGCCACCAGGGGGCGCTAATTTGGCCACCAGGGGGCGCTACCCGAAATACCTGACGATGCGGGACTA
synth47	GTCACTATACACTTTTTCTAGGACTATCTGATGAGTTCTCGTTACTGGCCACCAGGGGGCGCTAGTGGCCACCAGGGGGCGCTAAAGCCAGCTTGATGCT
synth48	ACCCACTACAGGGTGAGGTGGCCACCAGGGGGCGCTATTCGCACCTATTACGAGGTTGTGGCCACCAGGGGGCGCTAAGGTTCTTTAAAAGTAAACTAAC
synth49	TCTCTGCTATTTGTACAGAAACTCATTGACCGCAGTTACTTGGCCACCAGGGGGCGCTAGAGATTTGGCCACCAGGGGGCGCTAGACCTCCTCCTGTTAG
